11111111111111111111111111111111111111
1P0000010C0001000000000111110000000001
110C0100011100011111000000000011111001
10000011110000001111111111110000000001
11100000011111000001111100000011111111
10000C01111000000001111111110000000001
1111111111110000C000001111110000000001
11110011100000111101111100011111110001
1111110000000000000011110000000C000001
10000000C0000000P0000000000000E1111111
11111111111111111111111111111111111111